0000000000000000000000
0000000000000000000000
0000000000000000000000
0000000000000000000000
0000000000011000000000
0000000000122111100000
0000001100000000000000
0001112200000000000000
0000222210000000000000
0000000000001111100000
0000000000012222210000
1100000000122222220000
2211111111222222221111
2222222222222222222222