000000000000000000000000000000
000000000000000000000000000000
000000000000000000000000000000
000000000000000000000000000000
000000000000000000000000000000
000000011111000000000000000000
000000000000000000000000000000
110000000000000001100000011000
221111111111111112200001122100
222222222222222222200002222200
222222222222222222200000220000
222222222222222222200000200000
222222222222222222200000200000
222222222222222222200000000000