000001111100000
000111111111000
001111111111100
011111111111110
011111111111110
111111111111111
111111111111111
111111111111111
111111111111111
111111111111111
011111111111110
011111111111110
001111111111100
000111111111000
000001111100000