2222222222200000000000000000000000000000000000000000000000000000000000000000000000000000000000000000000000022222222222
2222222222200000000000000000000000000000000000000000000000000000000000000000000000000000000000000000000000022222222222
2222222222200000000000000000000000000000000000000000000000000000000000000000000000000000000000000000000000022222222222
2222222222200000000000000000000000000000000000000000000000000000000000000000000000000000000000000000000000022222222222
222222200000000000000000000000000000000000000000000000000000000000000000000000000000000000000000000000022222222222
222222200000000000000000000000000000000000000000000000000000000000000000000000000000000000000000000000022222222222
222222200000000000000000000000000000000000000000000000000000000000000000000000000000000000000000000000022222222222
222222200000000000000000000000000000000000000000000000000000000000000000000000000000000000000000000000022222222222
222222200000000000000000000000000000000000000000000000000000000000000000000000000000000000000000000000022222222222
222222200000000000000000000000000000000000000000000000000000000000000000000000000000000000000000000000022222222222
222222211111000000000000000000000000000000000000000000000000000000000000000000000000000000000000000000022222222222
222222222222110000000000000000000000111100000000000000000000000000000000000000000000000000000000000000022222222222
222222222222200000000000000000000111222211000000000000000000000000000000000000000000000000000000000000022222222222
222222222000000000000011111111111222222222111110000000000000000000000000000001111111111111111110000000022222222222
222222220000000000000002222222222222222222222000000000111111111111111100000000022222222222222200000000022222222222
222222200000000000000000000002222222222222200000000001222222222222222210000000000002222222200000000000022222222222
222222200000000000000000000000000000222200000000000012222222222222222221000000000000000000000000000000022222222222
222222200000000000000000000000000000000000000000000000002222222222220000000000000000000000000000000000022222222222
222222200000000000000000000000000000000000011111000000000000000000000000000000000000000000000000000000022222222222
222222200000000000000000000000001111110000222222100000000000000000000000000000000000000000000000000000022222222222
222222200000000000000000000001112222200002222222200000000000000000000000000000000000000000000000000000022222222222
222222200000000000000000000012222222000022222222000000000000000000000000000000000000000000000000000000022222222222
222222200000000000000000000022222220000000222220000000000000000000000000000000000000000000000000000000022222222222
222222200000000000000000000000000000011000000000000000000000000000000000000000000000000000000000000000022222222222
222222200000000000000000000000000000022100000000000000000000000000000000000000000000000000000000000000022222222222
222222200000000000000000000001111111122211111100000000000000000000000000000000000000000000000000000000022222222222
222222200000011111111100000000222222222222200000000000000000000000000000000000000000000000000000000000022222222222
222222200001122222222210000000002222222200000000000000000000000000000000000000000000000000000000000000022222222222
222222200002222222222221110000000220000000000000011111100000000000000000000000000000000000000000000000022222222222
222222200000000022222222221000000200000000000000000000011111110000000000000000000000000000000000000000022222222222
222222200000000000222222220000000200000000000000000000000000001111100000000000000000000000000000000000022222222222
222222200000000000020000000000000000000000000111100000000000000000011100000000000000000000000000000000022222222222
222222200000000000000000000000000000000000001000000000000000000000000010000000000000000000000000000000022222222222
222222200000000000000000000000000000000000000000000000000000000000000001110000000000000000000000000000022222222222
222222200000000000000000000000000000000000010000000000000000000000000000001111110000000000000000000000022222222222
222222200000000000000000000000000000000111100000000000000000000000000000000000000000000000000000000000022222222222
222222200000000000000000000011111111111000000000000000000000000000000000000000001111100000000000000000022222222222
222222211111111111111111111100000000000000000000000000000000000000000000000000000000011111111111111111122222222222
222222222222222222222222222222222222222222222222222222222222222222222222222222222222222222222222222222222222222222
222222222222222222222222222222222222222222222222222222222222222222222222222222222222222222222222222222222222222222
222222222222222222222222222222222222222222222222222222222222222222222222222222222222222222222222222222222222222222
222222222222222222222222222222222222222222222222222222222222222222222222222222222222222222222222222222222222222222
222222222222222222222222222222222222222222222222222222222222222222222222222222222222222222222222222222222222222222
222222222222222222222222222222222222222222222222222222222222222222222222222222222222222222222222222222222222222222