2222222222200000000000000000000000000000000000000000000000000000000000000000000000000000000000000000000000022222222222
2222222222200000000000000000000000000000000000000000000000000000000000000000000000000000000000000000000000022222222222
2222222222200000000000000000000000000000000000000000000000000000000000000000000000000000000000000000000000022222222222
2222222222200000000000000000000000000000000000000000000000000000000000000000000000000000000000000000000000022222222222
2222222222200000000000000000000000000000000000000000000000000000000000000000000000000000000000000000000000022222222222
2222222222200000000000000000000000000000000000000000000000000000000000000000000000000000000000000000000000022222222222
2222222222200000000000000000000000000000000000000000000000000000000000000000000000000000000000000000000000022222222222
2222222222200000000000000000000000000000000000000000000000000000000000000000000000000000000000000000000000022222222222
2222222222200000000000000000000000000000000000000000000000000000000000000000000000000000000000000000000000022222222222
2222222222200000000000000000000000000000000000000000000000000000000000000000000000000000000000000000000000022222222222
2222222222211111111111111111111111111111111100000011111111111111111111111111111111111111111111111111111111122222222222
2222222222222222222222222222222222222222222200000002222222222222222222222222222222222222222222222222222222222222222222
2222222222222222222222222222222222222222222220000000022222222222222222222222222222222222222222222222222222222222222222
2222222222222222222222222222222222222222222222000000000222222222222222222222222222222222222222222222222222222222222222
2222222222222222222222200000000000002222222222222200000022222222222222222222222222222222222222222222222222222222222222
2222222222222222200000000000000000000022222222222220000002222222222222222222222222222222222222222222222222222222222222
2222222222200000000000000000000000000000022222222222000000222222222222222222222222222222222222222222222222222222222222
2222222222200000000000000000000000000000000002222222000000000000002222222222222222222222222222222222222222222222222222
2222222222200000000000222222222220000000000000002220000000000000000000022222222222222222222222222222222222222222222222
2222222222222222222222222222222222222222220000000000002222222000000000000000022222222222222222222222222222222222222222
2222222222222222222222222222222222222222200000000000022222222200000000000000000000000022222222222222222222222222222222
2222222222222222222222222222222222222222000000000000222222222220000000000000000000000000000222222222222222222222222222
2222222222222222222222222222222222200000000002222222222222222222000000000000000000000000000022222222222222222222222222
2222222222222222222222222222200000000000000022222222222222222222200000000000000000000000000022222222222222222222222222
2222222222222222222222222222000000000000000222222222222222222222222000000000000000000000000022222222222222222222222222
2222222222222222222222222222000000000000000222222222222222222222222222000000000000000000000022222222222222222222222222
2222222222222222222222222222000000000000002222222222222222222222222222220000000000000000000022222222222222222222222222
2222222222222222222222222220000000000000022222222222222222222222222222222222222200000000000022222222222222222222222222
2222222222222222222222222200000000000222222222222222222222222222222222222222222222222200000022222222222222222222222222
2222222222222222222220000000000002222222222222222222222222222222222222220000000000000000000222222222222222222222222222
2222222222222222000000000000000022222222222222222222222222222222222200000000000000000000002222222222222222222222222222
2222222222222220000000000000000022222222222222222222222222222222200000000000000000000000022222222222222222222222222222
2222222222222220000000000000000002222222222222222222200000000000000000000000000000000022222222222222222222222222222222
2222222222222220000000000000000000000000000000000000000000000000000000000022222222222222222222222222222222222222222222
2222222222222222222222222222000000000000000000000000000000000002222222222222222222222222222222222222222222222222222222
2222222222222222222222222222222222222222222222222222222222222222222222222222222222222222222222222222222222222222222222
2222222222222222222222222222222222222222222222222222222222222222222222222222222222222222222222222222222222222222222222
2222222222222222222222222222222222222222222222222222222222222222222222222222222222222222222222222222222222222222222222
2222222222222222222222222222222222222222222222222222222222222222222222222222222222222222222222222222222222222222222222
2222222222222222222222222222222222222222222222222222222222222222222222222222222222222222222222222222222222222222222222
2222222222222222222222222222222222222222222222222222222222222222222222222222222222222222222222222222222222222222222222
2222222222222222222222222222222222222222222222222222222222222222222222222222222222222222222222222222222222222222222222
2222222222222222222222222222222222222222222222222222222222222222222222222222222222222222222222222222222222222222222222
2222222222222222222222222222222222222222222222222222222222222222222222222222222222222222222222222222222222222222222222