2222222222200000000000000000000000000000000000000000000000000000000000000000000000000000000000000000000000022222222222
2222222222200000000000000000000000000000000000000000000000000000000000000000000000000000000000000000000000022222222222
2222222222200000000000000000000000000000000000000000000000000000000000000000000000000000000000000000000000022222222222
2222222222200000000000000000000000000000000000000000000000000000000000000000000000000000000000000000000000022222222222
2222222222200000000000000000000000000000000000000000000000000000000000000000000000000000000000000000000000022222222222
2222222222200000000000000000000000000000000000000000000000000000000000000000000000000000000000000000000000022222222222
2222222222200000000000000000000000000000000000000000000000000000000000000000000000000000000000000000000000022222222222
2222222222200000000000000000000000000000000000000000000000000000000000000000000000000000000000000000000000022222222222
2222222222200000000000000000000000000000000000000000000000000000000000000000000000000000000000000000000000022222222222
2222222222200000000000000000000000000000000000000000000000000000000000000000000000000000000000000000000000022222222222
2222222222211111111111111000000000000000000000000000000000000000000000000000000000000000000000000000000000022222222222
2222222222200000000000000000000000000000000000000000000000000000000000000000000000000000000000000000000000022222222222
2222222222200000000000000000111111111111111111111111111110000000000000000000000000000000000000000000000000022222222222
2222222222200000000000000000000000000000000000000000000000000000000000000000000000000000000000000000000000022222222222
2222222222200000000000000000000000000000000000000000000000000000000000000000000000000000000000000000000000022222222222
2222222222200000000000000000000000000000000000000000000000000111111111111111111111111111111111111000000000022222222222
2222222222200000011111111111111111111111111110000000000000000000000000000000000000000000000000000000000000022222222222
2222222222200000000000000000000000000000000000000000000000000000000000000000000000000000000000000000000000022222222222
2222222222200000000000000000000000000000000000001111111111111111111111100000000000000000000000000000000000022222222222
2222222222200000000000000000000000000000000000000000000000000000000000000000000011111111111111111111000000022222222222
2222222222200000000000000000000000000000000000000000000000000000000000000001100000000000000000000000000000022222222222
2222222222200000000000000000000000000000000000000000000000000001111111111000000000000000000000000000000000022222222222
2222222222200000000000001111111111111111111111111111111111100000000000000000000000000000000000000000000000022222222222
2222222222200000000000000000000000000000000000000000000000000000000000000000000000000000000000000000000000022222222222
2222222222200000000000000000000000000000000000000000000000000000000000000000000000000000000000000000000000022222222222
2222222222200111111111111111111111111111111110000000000001111111111111111111111111111111111111100000000000022222222222
2222222222200000000000000000000000000000000000000000000000000000000000000000000000000000000000000000000000022222222222
2222222222200000000000000000000000000000000000011111100000000000000000000000000000000000000000000000000000022222222222
2222222222200000000000000000000000000000000000000000000000000011111111111111111111111111111111111000000000022222222222
2222222222200000000000000000000000000000000000000000000000000000000000000000000000000000000000000000000000022222222222
2222222222200000000111111111111111111111111111111111111111111000000000000000000000000000000000000000000000022222222222
2222222222200000000000000000000000000000000000000000000000000000000000000000000000000000000000000000000000022222222222
2222222222200000000000000000000000000000000000000000000000000000000000000000000000000000000000000000000000022222222222
2222222222200000000000000000000000000000000000000000000000000000111111111111111111111111111111110000000000022222222222
2222222222200000000000000000000000000000000000000000000000000000000000000000000000000000000000000000000000022222222222
2222222222200000000000000000111111111111111111111111111111111100000000000000000000000000000000000000000000022222222222
2222222222200000000000000000000000000000000000000000000000000000000000000000000000000000000000000000000000022222222222
2222222222200000000000000000000000000000000000000000000000000000000000000000000000000000000000000000000000022222222222
2222222222222222222222222222222222222222222222222222222222222222222222222222222222222222222222222222222222222222222222
2222222222222222222222222222222222222222222222222222222222222222222222222222222222222222222222222222222222222222222222
2222222222222222222222222222222222222222222222222222222222222222222222222222222222222222222222222222222222222222222222
2222222222222222222222222222222222222222222222222222222222222222222222222222222222222222222222222222222222222222222222
2222222222222222222222222222222222222222222222222222222222222222222222222222222222222222222222222222222222222222222222
2222222222222222222222222222222222222222222222222222222222222222222222222222222222222222222222222222222222222222222222